2 bla 10 7
1 mol 5 0
3 fla 10 4
1 fla 20 0
1 mol 15 3
2 zon 15 1
3 zon 0 0
2 mol 5 4
1 bla 15 5
1 fla 15 3
3 zon 15 9
3 mol 5 6
1 fla 12 2
2 bla 0 2