1 zon 1.5 10
2 bla 10 1
3 fla 10 3
1 fla 20 0
2 zon 5 1
3 zon 15 3
1 bla 15 5
1 fla 20 4
3 zon 15 5
1 fla 5 3
2 bla 0 8